NO ./assets/textures/north.xpm
SO ./assets/textures/south.xpm
WE ./assets/textures/west.xpm
EA ./assets/textures/east.xpm

F 220,100,0
C 0,30,0

11111111111111111111
10000000000000000001
10010101010101010101
10000000000000000001
10010101010101010101
10000000000000000001
10000000000000000001
10000000000000000001
10010101010101010101
10000000000000000001
10010101010101010101
10000000000000000001
11111111111111111111










   