NO ./assets/textures/1_no.xpm
SO ./assets/textures/1_so.xpm
WE ./assets/textures/1_we.xpm
EA ./assets/textures/1_ea.xpm
F 42,420,0
C 0,42,42

11111111111111111111
10000000000000000001
10010101010101010101
10000000000000000001
10010101010101010101
10000000000000000001
100000000W0000000001
10000000000000000001
10010101010101010101
10000000000000000001
10010101010101010101
10000000000000000001
11111111111111111111